#domain
hospital
#levelname
MADoDo
#colors
red: 0, I
green: 1, W
grey: 2, N
blue: 3, A, B, C, E, G, K, O, P, R, S
#initial
++++++++++++++++++++++++++
+0     1     2     3     +
+  I     W     N     B   +
+                        +
+BR NG+PO ER+RA GERS+ ACK+
++++++++++++++++++++++++++
#goal
++++++++++++++++++++++++++
+                        +
+                        +
+                        +
+  I  +  W  +  N    +B   +
++++++++++++++++++++++++++
#end
