#domain
hospital
#levelname
MAgroupname
#colors
red: 0, 1, A, B
green: 2
grey: 3, C
#initial
++++++++++++++++++++++++++++
+          1    0A B2C     +
+                  ++3     +
++++++++++++++++++++++++++++
#goal
++++++++++++++++++++++++++++
+     B                 A  +
+                  ++      +
++++++++++++++++++++++++++++
#end
