#domain
hospital
#levelname
MAKalle
#colors
red: 0, A
green: 1, 2, 3, 4, 5
blue: 6, B
#initial
+++++++++++
+6        +
+++++B+++++
+         +
+ +++3+++ +
+ +     + +
+ + +++ + +
+ + 102 +5+
+ + +++ + +
+ +     + +
+ +++4+++ +
+    A    +
+++++++++++
#goal
+++++++++++
+        A+
+++++ +++++
+         +
+ +++ +++ +
+ +     + +
+ + +++ + +
+ +     + +
+ + +++ + +
+ +     + +
+ +++ +++ +
+         +
+++++++++++
#end
