#domain
hospital
#levelname
SANeverMind
#colors
blue: 0, A, B, C
#initial
++++++++++++++
+A    ++++AAA+
+ ++         +
++++  A   + A+
++A+0+++  + ++
++++++      ++
++ +A   + + ++
+   +      A +
+B  +     A  +
+ A +  +++   +
+C+ +++      +
+ +  AAA     +
++++++++++++++
#goal
++++++++++++++
+     ++++   +
+ ++        A+
++++      +  +
++ + +++  + ++
++++++AAA  A++
++A+ A  + + ++
+   +AAAA    +
+   +AA      +
+C  +  +++   +
+ + +++      +
+B+          +
++++++++++++++
#end
