#domain
hospital
#levelname
MAMagicians
#colors
red: 0, A, B, C
green: 1, X, Y, Z
#initial
+++++++++++++++
+0XY          +
+++         BA+
+      1      +
+             +
+ +++++++++++ +
+ +++++++++++ +
+++++++++++++++
#goal
+++++++++++++++
+             +
+++           +
+             +
+             +
+B+++++++++++Y+
+A+++++++++++X+
+++++++++++++++
#end
