#domain
hospital
#levelname
MAZEROagent
#colors
red: 0, A
green: 1, B
blue: 2, C
grey: 3, D
#initial
++++++++++++++++++++++++++++++++++++++++
+ +                   +    +++         +
+ +                   +    +C+         +
+ +                   +    + +++++++++++
+ +                        +           +
+ +++++               +    + ++ + + +  +
+                     +++ ++ +  + + +  +
++++++++++++++        +   +  +  + + +  +
+                     + + + ++  + + +  +
+                     + + + ++  + + +  +
+                     + + + ++  + + +  +
+                     +D+ + ++  + + +  +
+                     +3+ + ++  + + +  +
+                     +++ + ++  + + +  +
+                       + + +   + + +  +
+                       + + +   + + +  +
+  2                    +   +   + + +  +
+                       +++++   ++++++ +
+           ++++++++++++++B+           +
+           +              +           +
+           + ++++++++++++++           +
+           + +            +           +
+         +++ +++++++++++++++++++++++ ++
+1        +                          A0+
++++++++++++++++++++++++++++++++++++++++
#goal
++++++++++++++++++++++++++++++++++++++++
+A+                   +    +++         +
+B+                   +    + +         +
+C+                   +    + +++++++++++
+ +                        +           +
+ +++++               +    + ++ + + +  +
+                     +++ ++ +  + + +  +
++++++++++++++        +   +  +  + + +  +
+                     + + + ++  + + +  +
+                     + + + ++  + + +  +
+                     + + + ++  + + +  +
+                     + + + ++  + + +  +
+                     + + + ++  + + +  +
+                     +++ + ++  + + +  +
+                       + + +   + + +  +
+                       + + +   + + +  +
+                       +   +   + + +  +
+                       +++++   ++++++ +
+           ++++++++++++++ +           +
+           +             D+           +
+           + ++++++++++++++           +
+           + +            +           +
+         +++ +++++++++++++++++++++++ ++
+         +                            +
++++++++++++++++++++++++++++++++++++++++
#end
