#domain
hospital
#levelname
SAAIFather
#colors
blue: 0, A, B, C, D
#initial
++++++++++++++++++++++++
++++++++ +++B+++ +++++++
+0 C      D        A   +
++++++++++++++++++++++++
#goal
++++++++++++++++++++++++
++++++++ +++ +++A+++++++
+ B                  DC+
++++++++++++++++++++++++
#end
