#domain
hospital
#levelname
MABlock2
#colors
red: 0, A
green: 1, B
#initial
++++++++++++++++++++++++++++++++++++++++++
+0++++1                                  +
+AB                                      +
+++++++ ++++++++++++++++++++++++++++++++++
+++++++++
#goal
++++++++++++++++++++++++++++++++++++++++++
+ ++++                                   +
+                                        +
+++++++A++++++++++++++++++++++++++++++++++
+++++++++
#end
