#domain
hospital
#levelname
MABlock3
#colors
red: 0, A
green: 1, 2, 3, B
#initial
++++++++++++++++++++++++++++++++++++++++++
+0++++1 BBBBB                            +
+AB                                      +
+++++++ ++++++++++++++++++++++++++++++++++
+++++++++
#goal
++++++++++++++++++++++++++++++++++++++++++
+ ++++                                   +
+                                   BBBBB+
+++++++A++++++++++++++++++++++++++++++++++
+++++++++
#end
