#domain
hospital
#levelname
MABlock4
#colors
red: 0, A
green: 1, B
#initial
++++++++++++
+1   +++   +
+    +++ A +
+ 0 BBBBB  +
+    +++   +
+    +++   +
++++++++++++
#goal
++++++++++++
+    +++  A+
+    +++   +
+          +
+    +++   +
+    +++   +
++++++++++++
#end
