#domain
hospital
#levelname
MAImpossible
#colors
red: 0, A
green: 1, B
#initial
+++++++++++++++++++++++++++++++++++++++++++++++
+ A1                                       0B +
+++++++++++++++++++++++++++++++++++++++++++++++
#goal
+++++++++++++++++++++++++++++++++++++++++++++++
+A                                           B+
+++++++++++++++++++++++++++++++++++++++++++++++
#end
