#domain
hospital
#levelname
SANotHard
#colors
blue: 0, A, B, C, D, E, F, G, H, I
#initial
++++++++++++++++
+ +++ +++ ++++++
+ +++ +++ ++++++
+ +++ +++ ++++++
+ +++ +++ ++++++
+ +++ +++ ++++++
+  0           +
+              +
+   ABCDEFGHI  +
++++++++++++++++
#goal
++++++++++++++++
+A+++B+++C++++++
+D+++E+++F++++++
+G+++H+++I++++++
+ +++ +++ ++++++
+ +++ +++ ++++++
+              +
+              +
+              +
++++++++++++++++
#end
