#domain
hospital
#levelname
MABlinky
#colors
red: 0,B
#initial
++++++++++++++
+            +
+      +++++ +
+      + +B+ +
+      +     +
+++++ ++++++++
+           B+
+ ++++       +
+ ++++       +
+     0      +
++++++++++++++
#goal
++++++++++++++
+            +
+      +++++ +
+      +B+ + +
+      +     +
+++++ ++++++++
+            +
+B++++       +
+ ++++       +
+            +
++++++++++++++
#end