#domain
hospital
#levelname
SAZEROagent
#colors
blue: 0, A, B, C, D, E, G, H, I, J
#initial
+++++++++++++++++++++
+ +                 +
+ +G B C D E HIJ    +
+ +                 +
+ +                 +
+ +                 +
+ +                 +
+ +                 +
+ +                 +
+ +                 +
+ +                 +
+ +                 +
+ +                 +
+ +                 +
+                   +
+                   +
+                   +
+       +++++++++++++
+     A0+++++++++++++
+++++++++++++++++++++
#goal
+++++++++++++++++++++
+A+                 +
+B+                 +
+C+                 +
+D+                 +
+E+                 +
+G+                 +
+H+                 +
+I+                 +
+J+                 +
+ +                 +
+ +                 +
+ +                 +
+ +                 +
+                   +
+                   +
+                   +
+       +++++++++++++
+       +++++++++++++
+++++++++++++++++++++
#end
